1111111111111
100C0000C00C1
100C0CCCC1001
1P0C011E00001
1111111111111
